11111111111111111
1P000000C000000E1
11111111111111111