1111111111
1P0001C001
110C011001
1000011001
1C00000001
1111011111
1C000000E1
1110111111
1C000000C1
1111111111