111111111111111
1P00C11110C0011
111001111100011
1H0000000000011
110011111111011
11001000000C011
110010101110011
11001C100010011
111011101011111
11C0000H1000001
111111111111101
1000C00111C0001
101111000011011
100EC11110000C1
111111111111111