111111111111111
1P00C111H0C0011
111001111V00111
100001C00000011
110011111111011
11001H00000C011
110010101110011
1H001C101000011
110011101011111
11000000101C001
111111101111101
1000C00H00C0001
101110101111011
10E000C01C00001
111111111111111